#############################
#                           #
#                           #
#                           #
#                           #
#	                        #
#	                        #
#                           #
#                           #
#			                #
#                           #
#	                        #
#                           #
#			                # 
#                           #
#		                    #  
#                           #
#                           #
#                           #
#                           #
#		                    #
#		                    #
#                           #
#                           #
#                           #
#                           #
#                           #
#                           #
#                           #
#                           #
#############################