####################                                        ####################
#                  #                                        #                  #
#                  #                                        #                  #
#                  #                                        #                  #
#                  #                                        #                  #
#                  #          # # # # # # # # # #           #                  #
#                  #                                        #                  #
#                  #                                        #                  #
#                  #                                        #                  #
#                  #                                        #                  #





####################                                        ####################






#                   #                                       #                  #
#                   #                                       #                  #
#                   #                                       #                  #
#                   #                                       #                  #
#                   #         # # # # # # # # # #           #                  #
#                   #                                       #                  #
#                   #                                       #                  #
#                   #                                       #                  #
#                   #                                       #                  #
####################                                        ####################
		                    
  