

################################

  ##############################
  
    ############################
	   
	    ########################

		   #####################

		      ##################

			     ###############

				     ###########

					    ########
						 
						   #####

						     ###
							  
							   #
  