####################                                        ####################
#                  #                                        #                  #
#                  #                                        #                  #
#                  #        #                     #         #                  #
#                  #         #                   #          #                  #
#                  #          # # # # # # # # # #           #                  #
#                  #                   #                    #                  #
#                  #                                        #                  #
#                  #                                        #                  #
#                  #                   #                    #                  #


                                       #


####################                   #                    ####################


                                       #


									   #
#                   #                                       #                  #
#                   #                                       #                  #
#                   #                  #                    #                  #
#                   #                                       #                  #
#                   #         # # # # # # # # # #           #                  #
#                   #        #                   #          #                  #
#                   #       #                     #         #                  #
#                   #                                       #                  #
#                   #                                       #                  #
####################                                        ####################
							  
							   
  